.

BBBBBBBBBBB

B...B.B..CB

B.B.B.B.BBB

B.B.......B

B.BBBB.BB.B

B.B.....B.B

BBBBBBBBBBB